00500193
00400113
010000EF
00402223
00402283
00520663
40310233
00008067
